-------------------Important Info---------------------------

 Starting there is  TW for mental health related topics. This game is a game about disassociation and could be a trigger for some. 

The score in the game is your sanity/ self image. You start with 5, and can check it with score. Get too high and something bad may happen. In other words try to get a low score. Another part of the scoring is that you will consistently take damage to your sanity, sometimes even when you do something good you'll be punished because you got another one of those pings... it sucks, I know.

You will need to know a special part of this game, that is the phone. The phone is a room not an object so treat it as such. Throughout the game text will be highlighted... this may mean you can interact with typing it out ;)

-------------------Begin--------------------------- 
I think somethings wrong...
Something is wrong... by Luke Rowe
Release 1 / Serial number 230123 / Inform 7 v10.1.2 / D

Phone
You are on your phone, scrolling endlessly with no end in sight.

A water main broke, leaving New Orleans without drinking water, and the flooding here is getting worse after waters from Lake Pontchartrain broke through a levee. 
 scroll 
 The Crips & Bloods tried to establish themselves here, and these guys killed them. Simple as that-gone! See you later! 
 scroll 
 Music Intro: Steve Lacy I wish I knew you wanted me I wish I knew, I wish I knew you wanted me I wish I knew, I wish I knew you wanted me 

Slowly you begin to hear a high pitch sound which you could listen to possibly. You start feeling an unease. Maybe you should put the phone down.

You could also stay on your phone in your endless lull.  scrolling, maybe that feeling of unease could just be random. Go and see whats going on with your phone.  What time was it again?

 I also have snapchat  I could examine it but... there's no point, I don't ever get sent anything.

 You start with 5 sanity load

>l
Classroom

>look
Classroom

>m
That's not a verb I recognise.

>e
You can't go that way.

>a
That's not a verb I recognise.

>s
You can't go that way.

>w
You can't go that way.

>x
What do you want to examine?

>x room
You can't see any such thing.

* * *

>enter the mind
You can't see any such thing.

>help
That's not a verb I recognise.

>h
That's not a verb I recognise.

* * *

>s
You can't go that way.

>n
Phone
You are on your phone, scrolling endlessly with no end in sight. You could possibly keep scrolling diving deeper into the void, the numbing of your mind. Slowly you begin to hear a high pitch sound. You start feeling an unease. Maybe you should put the phone down.

>put down the phone
You can't see any such thing.

* * *

>s
You can't go that way.

>look
Bedroom
Your bedroom, the walls look kind of silly. Did the walls stucco always slide like that?

>s
You can't go that way.

* * *

>n
Phone
You are on your phone, scrolling endlessly with no end in sight. You could possibly keep scrolling diving deeper into the void, the numbing of your mind. Slowly you begin to hear a high pitch sound. You start feeling an unease. Maybe you should put the phone down.

>s
Room
A boring old room

* * *

>s
You can't go that way.

>pick up water bottle
Taken.

>inventory
You are carrying:
  a water bottle

* * *

>s
You can't go that way.

>drink
(the water bottle)
There's nothing suitable to drink here.

>inventory
You are carrying nothing.

>pick up water bottle
Taken.

>drink
(the water bottle)
There's nothing suitable to drink here.

>drink water bottle
There's nothing suitable to drink here.

>drink watter
You can't see any such thing.

* * *

>s
You can't go that way.

>take water
Taken.

>i
You are carrying:
  Water bottle
    liquid

>drink water
There's nothing suitable to drink here.

>drink water bottle
There's nothing suitable to drink here.

* * *

>take water
Taken.

>drink from water bottle
You must supply a noun.

>x water bottle
In Water bottle is liquid.

>examine liquid
You see nothing special about liquid.

* * *

>s
You can't go that way.

>drink from water bottle
There's nothing suitable to drink here.

>t water
That's not a verb I recognise.

>take water
Taken.

>drink from water bottle
There's nothing suitable to drink here.

* * *

>s
You can't go that way.

>take bottle
Taken.

>look
Bedroom
Your bedroom, the walls look kind of silly. Did the walls stucco always slide like that?

>examine bottle
In Bottle is liquid.

>examine liquid
Looks like water, smells like nothing maybe  a little bit of metal? It looks off. Did the bottle always feel so heavy?

* * *

>s
You can't go that way.

>DP
Bedroom
Your bedroom, the walls look kind of silly. Did the walls stucco always slide like that?

You can see Bottle (in which is liquid) here.

* * *

>put the phone down
What do you want to put DP in?

>put phone down
What do you want to put DP in?

>phone ddown
You can't see any such thing.

>phone down
Bedroom
Your bedroom, the walls look kind of silly. Did the walls stucco always slide like that?

You can see Bottle (in which is liquid) here.

* * *

>set phone down
You can't see any such thing.

>s
Bedroom
Your bedroom, the walls look kind of silly. Did the walls stucco always slide like that?

You can see Bottle (in which is liquid) here.

>take bottle
Taken.

>drink liquid
There's nothing suitable to drink here.

>x liquid
Looks like water, smells like nothing... maybe  a little bit of metal? It looks off. Did the bottle always feel so heavy?

You look back up at your room there is a big blur and your eyes take time to readjust. You flop back into your bed as if picking up the bottle was too exhausting. You begin to get a headache.

* * *

>set phone down
You can't see any such thing.

>put phone down
You can't see any such thing.

* * *

>set phone down
You can't see any such thing.

>set down
I didn't understand that sentence.

>set down
I didn't understand that sentence.

>set
What do you want to set?

>down phone
I didn't understand that sentence.

* * *

>put down the phone
You can't see any such thing.

>put down phone
You can't see any such thing.

>s
Bedroom
Your bedroom, the walls look kind of silly. Did the walls stucco always slide like that?

You can see Bottle (in which is liquid) here.

* * *

>south
You can't go that way.

>south
Bathroom
Your bathroom, it seems kind of small. The corners of the room seem to be swaying inward. Other than that its a normal bathroom with a shower. Nothing special.

>look
Bathroom
Your bathroom, it seems kind of small. The corners of the room seem to be swaying inward. Other than that its a normal bathroom with a shower. Nothing special.

>x mirror
A mirror, its reflections seem to be waving at me.

* * *

>south
You can't go that way.

>dp
Bedroom
Your bedroom, the walls look kind of silly. Did the walls stucco always slide like that? Your bathroom is south of the Bedroom, the closet is to the east, the door to the outside to the northeast

You can see Bottle (in which is liquid) here.

>south
The Bathroom
Your bathroom, it seems kind of small. The corners of the room seem to be swaying inward. Other than that its a normal bathroom with a shower and a mirror that's refracting some weird looking objects. I probably look like shit.

Self is a man sitting in your head, but your thoughts are jumbled.

Your head throbs, your vision gets blurry. You stare at nothing for a little. You come back to.

[Your score has just gone up by three points.]

>shower
I feel much better after that. Things are starting to feel right again.

[Your score has just gone down by ten points.]

>north
Bedroom
Your bedroom, the walls look kind of silly. Did the walls stucco always slide like that? Your bathroom is south of the Bedroom, the door to the outside to the east

You can see Bottle (in which is liquid) here.

>score
You have so far scored -10 out of a possible 0, in 6 turns.

>east
    *** You made it outside... things start to feel right, you see your friend and talk with them. Your phone stops being so cryptic and you see a message from your girlfriend. You feel relief and you continue your day ***

In that game you scored -10 out of a possible 0, in 6 turns.

Would you like to RESTART, RESTORE a saved game, QUIT or UNDO the last command?

>restart
-------------------Important Info---------------------------

The score in the game is bad. Think of it as your sanity load. Get to high and something may happen.

You will need to know some commands, most commands are basic however here are two important ones:

Phone Down, and Phone Up. This is how you access the phone. The phone can only be used in the bedroom, it in itself is a room. Treat it as such and potentially explore it.

I think somethings wrong...
Something is wrong... by Luke Rowe
Release 1 / Serial number 230118 / Inform 7 v10.1.2 / D

Phone
You are on your phone, scrolling endlessly with no end in sight. You could possibly keep scrolling diving deeper into the void, the numbing of your mind.

A water main broke, leaving New Orleans without drinking water, and the flooding here is getting worse after waters from Lake Pontchartrain broke through a levee. 
 scroll 
 The Crips & Bloods tried to establish themselves here, and these guys killed them. Simple as that-gone! See you later! 
 scroll 
 Music Intro: Steve Lacy I wish I knew you wanted me I wish I knew, I wish I knew you wanted me I wish I knew, I wish I knew you wanted me 

Slowly you begin to hear a high pitch sound. You start feeling an unease. Maybe you should put the phone down.

Additionally you could continue to scroll. That feeling of unease could just be random. Go and see whats going on with your phone.

>scroll
EEEEER, EEEER, STOP STOP STOP, GSCH GSCH GSCH. Waaaackrrr ssshhhh... NOOOOO WHY WHY, WHY WHY

I'm starting to not feel so good.

 your head throbs, your vision gets blurry. You stare at nothing for a little. You come back to.

[Your score has just gone up by thirteen points.]

>dp
Bedroom
Your bedroom, the walls look kind of silly. Did the walls stucco always slide like that? Your bathroom is south of the Bedroom, the door to the outside to the east

You can see Bottle (in which is liquid) here.

>east
I couldn't possibly go outside... I feel horrible, something isn't right

>drink liquid
You take a sip of the liquid. You feel a sense that it doesn't taste right... something isn't right... you start to feel ill. 
Hey the headache is subsiding at least, something just doesn't feel right, your field of vision blurs for a second and comes back to
[Your score has just gone down by five points.]

>score
You have so far scored 8 out of a possible 0, in 5 turns.

>score
You have so far scored 8 out of a possible 0, in 5 turns.

>esat
That's not a verb I recognise.

>east
I couldn't possibly go outside... I feel horrible, something isn't right

>look
Bedroom
Your bedroom, the walls look kind of silly. Did the walls stucco always slide like that? Your bathroom is south of the Bedroom, the door to the outside to the east

You can see Bottle (empty) here.

>south
The Bathroom
Your bathroom, it seems kind of small. The corners of the room seem to be swaying inward. Other than that its a normal bathroom with a shower. Nothing special. I probably look like shit.

Self is a man sitting in your head, but your thoughts are jumbled

>x self
(Self)
talking to myself could help a bit... maybe I can figure out what is going on.

>talk to self
(Self)
What am I doing right now, why is everything so weird. Am I okay? What is happening?

Everything is going to be okay. I should try to do some things that will make me feel better.

>talk to self
(Self)
What am I doing right now, why is everything so weird. Am I okay? What is happening?

Everything is going to be okay. I should try to do some things that will make me feel better.

 your head throbs, your vision gets blurry. You stare at nothing for a little. You come back to.

[Your score has just gone up by three points.]

>score
You have so far scored 11 out of a possible 0, in 11 turns.

>g
You have so far scored 11 out of a possible 0, in 11 turns.

>shower
I feel much better after that. Things are starting to feel right again.

[Your score has just gone down by ten points.]

>shower
I feel much better after that. Things are starting to feel right again.

[Your score has just gone down by ten points.]

>north
Bedroom
Your bedroom, the walls look kind of silly. Did the walls stucco always slide like that? Your bathroom is south of the Bedroom, the door to the outside to the east

You can see Bottle (empty) here.

>east
    *** You made it outside... things start to feel right, you see your friend and talk with them. Your phone stops being so cryptic and you see a message from your girlfriend. You feel relief and you continue your day ***

In that game you scored -9 out of a possible 0, in 14 turns.

Would you like to RESTART, RESTORE a saved game, QUIT or UNDO the last command?

>restart
-------------------Important Info---------------------------

The score in the game is bad. Think of it as your sanity load. Get to high and something may happen.

You will need to know some commands, most commands are basic however here are two important ones:

Phone Down, and Phone Up. This is how you access the phone. The phone can only be used in the bedroom, it in itself is a room. Treat it as such and potentially explore it.

I think somethings wrong...
Something is wrong... by Luke Rowe
Release 1 / Serial number 230118 / Inform 7 v10.1.2 / D

Phone
You are on your phone, scrolling endlessly with no end in sight. You could possibly keep scrolling diving deeper into the void, the numbing of your mind.

A water main broke, leaving New Orleans without drinking water, and the flooding here is getting worse after waters from Lake Pontchartrain broke through a levee. 
 scroll 
 The Crips & Bloods tried to establish themselves here, and these guys killed them. Simple as that-gone! See you later! 
 scroll 
 Music Intro: Steve Lacy I wish I knew you wanted me I wish I knew, I wish I knew you wanted me I wish I knew, I wish I knew you wanted me 

Slowly you begin to hear a high pitch sound. You start feeling an unease. Maybe you should put the phone down.

Additionally you could continue to scroll. That feeling of unease could just be random. Go and see whats going on with your phone.

>scroll
Bwhahabbsahs. SCHHKKK... (catchy music) sssssssssssssssss...

>scroll
Bwhahabbsahs. SCHHKKK... (catchy music) sssssssssssssssss...

>g
Wamp womp wamp womp... e e e, gir gir tir te..

 your head throbs, your vision gets blurry. You stare at nothing for a little. You come back to.

[Your score has just gone up by three points.]

>g
Wamp womp wamp womp... e e e, gir gir tir te..

 your head throbs, your vision gets blurry. You stare at nothing for a little. You come back to.

[Your score has just gone up by three points.]

>g
Bwhahabbsahs. SCHHKKK... (catchy music) sssssssssssssssss...

>g
Bwhahabbsahs. SCHHKKK... (catchy music) sssssssssssssssss...

>g
EEEEER, EEEER, STOP STOP STOP, GSCH GSCH GSCH. Waaaackrrr ssshhhh... NOOOOO WHY WHY, WHY WHY

I'm starting to not feel so good.

 your head throbs, your vision gets blurry. You stare at nothing for a little. You come back to.

[Your score has just gone up by thirteen points.]

>g
Bwhahabbsahs. SCHHKKK... (catchy music) sssssssssssssssss...

>g
Wamp womp wamp womp... e e e, gir gir tir te..

>g
Wamp womp wamp womp... e e e, gir gir tir te..

 your head throbs, your vision gets blurry. You stare at nothing for a little. You come back to.

[Your score has just gone up by three points.]

>g
EEEEER, EEEER, STOP STOP STOP, GSCH GSCH GSCH. Waaaackrrr ssshhhh... NOOOOO WHY WHY, WHY WHY

I'm starting to not feel so good.

    *** You succumb. You stare at the walls around you and you fade. You get pulled in, you don't come back. You are now stuck. You never will experience anything else but this hell. You can't move, you can't think ***

In that game you scored 32 out of a possible 0, in 13 turns.

Would you like to RESTART, RESTORE a saved game, QUIT or UNDO the last command?

* * *

>south
The Bathroom
Your bathroom, it seems kind of small. The corners of the room seem to be swaying inward. Other than that its a normal bathroom with a shower and a mirror that's refracting some weird looking objects. I probably look like shit.

Self is a man sitting in your head, but your thoughts are jumbled.

Your head throbs, your vision gets blurry. You stare at nothing for a little. You come back to.

[Your score has just gone up by three points.]

>talk to self
(Self)
What am I doing right now, why is everything so weird. Am I okay? What is happening?

Everything is going to be okay. I should try to do some things that will make me feel better.

>1
That's not a verb I recognise.

>yes
She looks interested.

* * *

>south
The Bathroom
Your bathroom, it seems kind of small. The corners of the room seem to be swaying inward. Other than that its a normal bathroom with a shower and a mirror that's refracting some weird looking objects. I probably look like shit.

Self is a man sitting in your head, but your thoughts are jumbled.

Your head throbs, your vision gets blurry. You stare at nothing for a little. You come back to.

[Your score has just gone up by three points.]

>tlk to self
That's not a verb I recognise.

>talk to self
(Self)
What am I doing right now, why is everything so weird. Am I okay? What is happening?

1. Things don't always seem wrong. Somethings just up right now. 2. Everything is going to be okay. 3. I should try to do some things that will make me feel better.

>1
Your right... just go with the flow.

Your head throbs, your vision gets blurry. You stare at nothing for a little. You come back to.

[Your score has just gone down by one point.]

>2
No it's not, it never is, this always happens... I always come back to this... Why me, why is this happening right now I can't escape.

[Your score has just gone up by three points.]

>3
Just focus on doing something productive, the less I think about this the better
[Your score has just gone down by four points.]

>score
You have so far scored 6 out of a possible 0, in 8 turns.

>shower
I feel much better after that. Things are starting to feel right again.

Your head throbs, your vision gets blurry. You stare at nothing for a little. You come back to.

[Your score has just gone down by seven points.]

>score
You have so far scored -1 out of a possible 0, in 9 turns.

>north
Bedroom
Your bedroom, the walls look kind of silly. Did the walls stucco always slide like that? Your bathroom is south of the Bedroom, the closet is to the east, the door to the outside to the northeast

You can see Bottle (in which is liquid) here.

 You lose sight of what you are doing. You put your hands up and they look oddly distant. You say:  Are these even my hands?

[Your score has just gone up by three points.]

>east
closet
Kinda running low on clothes... man everything is so outdated, I never get new clothes, I NEVER get anything good for myself, I think I have some things I can wear though...

You gaze at the corner of the closet and stare at how dark it is. Your gaze wanders across the clothing rack, then slowly throughout the rest of it. The felt and fabrics begin to seem like a mirage, fake almost... you get a ping. You snap back to.

You can see a Berserk Hoodie and a Black Joggers here.

>hoodie
That's not a verb I recognise.

>wear hoodie
(first taking the Berserk Hoodie)

 You lose sight of what you are doing. You put your hands up and they look oddly distant. You say:  Are these even my hands?

[Your score has just gone down by two points.]

>take joggers
Taken.

>wear joggers
[Your score has just gone down by five points.]

>west
Bedroom
Your bedroom, the walls look kind of silly. Did the walls stucco always slide like that? Your bathroom is south of the Bedroom, the closet is to the east, the door to the outside to the northeast

You can see Bottle (in which is liquid) here.

>ne
    *** You made it outside... things start to feel right, you see your friend and talk with them. Your phone stops being so cryptic and you see a message from your girlfriend. You feel relief and you continue your day ***

In that game you scored -5 out of a possible 0, in 15 turns.

Would you like to RESTART, RESTORE a saved game, QUIT or UNDO the last command?

>restart
-------------------Important Info---------------------------

 Starting there is  TW for mental health related topics. This game is a game about disassociation and could be a trigger for some. 

The score in the game is your sanity/ self image. You start with 5, and can check it with score. Get too high and something bad may happen. In other words try to get a low score. Another part of the scoring is that you will consistently take damage to your sanity, sometimes even when you do something good you'll be punished because you got another one of those pings... it sucks, I know.

You will need to know a special part of this game, that is the phone. The phone is a room not an object so treat it as such. Throughout the game text will be highlighted... this may mean you can interact with typing it out ;)

-------------------Begin--------------------------- 
I think somethings wrong...
Something is wrong... by Luke Rowe
Release 1 / Serial number 230123 / Inform 7 v10.1.2 / D

Phone
You are on your phone, scrolling endlessly with no end in sight.

A water main broke, leaving New Orleans without drinking water, and the flooding here is getting worse after waters from Lake Pontchartrain broke through a levee. 
 scroll 
 The Crips & Bloods tried to establish themselves here, and these guys killed them. Simple as that-gone! See you later! 
 scroll 
 Music Intro: Steve Lacy I wish I knew you wanted me I wish I knew, I wish I knew you wanted me I wish I knew, I wish I knew you wanted me 

Slowly you begin to hear a high pitch sound which you could listen to possibly. You start feeling an unease. Maybe you should put the phone down.

You could also stay on your phone in your endless lull.  scrolling, maybe that feeling of unease could just be random. Go and see whats going on with your phone.  What time was it again?

 I also have snapchat  I could open it but... there's no point, I don't ever get sent anything.

 You start with 5 sanity load

>check time
The time is 12:13, it way to early for this to be happening. Normally it's only at night this happens... what am I doing
[Your score has just gone up by three points.]

>score
You have so far scored 8 out of a possible 0, in 2 turns.

>restart
Are you sure you want to restart?

>yes
-------------------Important Info---------------------------

 Starting there is  TW for mental health related topics. This game is a game about disassociation and could be a trigger for some. 

The score in the game is your sanity/ self image. You start with 5, and can check it with score. Get too high and something bad may happen. In other words try to get a low score. Another part of the scoring is that you will consistently take damage to your sanity, sometimes even when you do something good you'll be punished because you got another one of those pings... it sucks, I know.

You will need to know a special part of this game, that is the phone. The phone is a room not an object so treat it as such. Throughout the game text will be highlighted... this may mean you can interact with typing it out ;)

-------------------Begin--------------------------- 
I think somethings wrong...
Something is wrong... by Luke Rowe
Release 1 / Serial number 230123 / Inform 7 v10.1.2 / D

Phone
You are on your phone, scrolling endlessly with no end in sight.

A water main broke, leaving New Orleans without drinking water, and the flooding here is getting worse after waters from Lake Pontchartrain broke through a levee. 
 scroll 
 The Crips & Bloods tried to establish themselves here, and these guys killed them. Simple as that-gone! See you later! 
 scroll 
 Music Intro: Steve Lacy I wish I knew you wanted me I wish I knew, I wish I knew you wanted me I wish I knew, I wish I knew you wanted me 

Slowly you begin to hear a high pitch sound which you could listen to possibly. You start feeling an unease. Maybe you should put the phone down.

You could also stay on your phone in your endless lull.  scrolling, maybe that feeling of unease could just be random. Go and see whats going on with your phone.  What time was it again?

 I also have snapchat  I could open it but... there's no point, I don't ever get sent anything.

 You start with 5 sanity load

>dp
Bedroom
Your bedroom, the walls look kind of silly. Did the walls stucco always slide like that? Your bathroom is south of the Bedroom, the closet is to the east, the door to the outside to the northeast

You can see Bottle (in which is liquid) here.

>east
closet
Kinda running low on clothes... man everything is so outdated, I never get new clothes, I NEVER get anything good for myself, I think I have some things I can wear though...

You gaze at the corner of the closet and stare at how dark it is. Your gaze wanders across the clothing rack, then slowly throughout the rest of it. The felt and fabrics begin to seem like a mirage, fake almost... you get a ping. You snap back to.

You can see a Berserk Hoodie and a Black Joggers here.

>wear hoodie
(first taking the Berserk Hoodie)

 You lose sight of what you are doing. You put your hands up and they look oddly distant. You say:  Are these even my hands?

[Your score has just gone down by two points.]

>wear joggers
(first taking the Black Joggers)
[Your score has just gone down by five points.]

>score
You have so far scored -2 out of a possible 0, in 5 turns.

>west
Bedroom
Your bedroom, the walls look kind of silly. Did the walls stucco always slide like that? Your bathroom is south of the Bedroom, the closet is to the east, the door to the outside to the northeast

You can see Bottle (in which is liquid) here.

 You lose sight of what you are doing. You put your hands up and they look oddly distant. You say:  Are these even my hands?

[Your score has just gone up by three points.]

>look
Bedroom
Your bedroom, the walls look kind of silly. Did the walls stucco always slide like that? Your bathroom is south of the Bedroom, the closet is to the east, the door to the outside to the northeast

You can see Bottle (in which is liquid) here.

>score
You have so far scored 1 out of a possible 0, in 7 turns.

* * *

>hello
Bedroom
Your bedroom, the walls look kind of silly. Did the walls stucco always slide like that?

You can see Bottle (in which is liquid) here.

* * *

>gg
Bedroom
Your bedroom, the walls look kind of silly. Did the walls stucco always slide like that?

You can see Bottle (in which is liquid) here.

* * *

>down phone
Bedroom
Your bedroom, the walls look kind of silly. Did the walls stucco always slide like that?

You can see Bottle (in which is liquid) here.

* * *

>put phone down
*** Run-time problem P12: Too many activities are going on at once.

[ The game has finished ]

* * *

>set down phone
*** Run-time problem P12: Too many activities are going on at once.

[ The game has finished ]

* * *

>take scroll
You can't see any such thing.

>scroll
Bwhahabbsahs. SCHHKKK... (catchy music) sssssssssssssssss.

* * *

>scroll
Wamp womp wamp womp... e e e, gir gir tir te..

>scroll
Wamp womp wamp womp... e e e, gir gir tir te..

 You lose sight of what you are doing. You put your hands up and they look oddly distant. You say:

 Are these even my hands?

[Your score has just gone up by three points.]

>scroll
Bwhahabbsahs. SCHHKKK... (catchy music) sssssssssssssssss...

I'm going insane i can't bare this anymore, please make it stop... I need to lay down, I need to do something. I can't do this, what am I doing. Something is off please let me out.
 You lose sight of what you are doing. You put your hands up and they look oddly distant. You say:

 Are these even my hands?

[Your score has just gone up by three points.]

>l
Phone
You are on your phone, scrolling endlessly with no end in sight. You could possibly keep scrolling diving deeper into the void, the numbing of your mind. Slowly you begin to hear a high pitch sound. You start feeling an unease. Maybe you should put the phone down. (phone down)

Additionally you could continue to scroll. Maybe like some content? See whats going on with your phone.

>l
Phone
You are on your phone, scrolling endlessly with no end in sight. You could possibly keep scrolling diving deeper into the void, the numbing of your mind. Slowly you begin to hear a high pitch sound. You start feeling an unease. Maybe you should put the phone down. (phone down)

Additionally you could continue to scroll. Maybe like some content? See whats going on with your phone.

>scroll
EEEEER, EEEER, STOP STOP, GSCH GSCH GSCH. Waaaackrrr ssshhhh

>scroll
EEEEER, EEEER, STOP STOP, GSCH GSCH GSCH. Waaaackrrr ssshhhh

>scroll
Bwhahabbsahs. SCHHKKK... (catchy music) sssssssssssssssss

>scroll
EEEEER, EEEER, STOP STOP, GSCH GSCH GSCH. Waaaackrrr ssshhhh

* * *

>scroll
Bwhahabbsahs. SCHHKKK... (catchy music) sssssssssssssssss...

I'm going insane i can't bare this anymore, please make it stop... I need to lay down, I need to do something. I can't do this, what am I doing. Something is off please let me out.
 You lose sight of what you are doing. You put your hands up and they look oddly distant. You say:

 Are these even my hands?

[Your score has just gone up by three points.]

>scroll
Bwhahabbsahs. SCHHKKK... (catchy music) sssssssssssssssss...

 your head throbs, your vision gets blurry. You stare at nothing for a little. You come back to.

[Your score has just gone up by three points.]

>scroll
Bwhahabbsahs. SCHHKKK... (catchy music) sssssssssssssssss...

>scroll
EEEEER, EEEER, STOP STOP STOP, GSCH GSCH GSCH. Waaaackrrr ssshhhh... NOOOOO WHY WHY, WHY WHY

I'm starting to not feel so good.

[Your score has just gone up by ten points.]

>scroll
Bwhahabbsahs. SCHHKKK... (catchy music) sssssssssssssssss...

>scroll
EEEEER, EEEER, STOP STOP STOP, GSCH GSCH GSCH. Waaaackrrr ssshhhh... NOOOOO WHY WHY, WHY WHYIm starting to get not feel good
[Your score has just gone up by ten points.]

>dp
Bedroom
Your bedroom, the walls look kind of silly. Did the walls stucco always slide like that?

You can see Bottle (in which is liquid) here.

>look
Bedroom
Your bedroom, the walls look kind of silly. Did the walls stucco always slide like that?

You can see Bottle (in which is liquid) here.

>look
Bedroom
Your bedroom, the walls look kind of silly. Did the walls stucco always slide like that?

You can see Bottle (in which is liquid) here.

I beg your pardon?

>look
Bedroom
Your bedroom, the walls look kind of silly. Did the walls stucco always slide like that?

You can see Bottle (in which is liquid) here.

>look
Bedroom
Your bedroom, the walls look kind of silly. Did the walls stucco always slide like that?

You can see Bottle (in which is liquid) here.

 your head throbs, your vision gets blurry. You stare at nothing for a little. You come back to.

[Your score has just gone up by three points.]

I beg your pardon?

>look
Bedroom
Your bedroom, the walls look kind of silly. Did the walls stucco always slide like that?

You can see Bottle (in which is liquid) here.

 your head throbs, your vision gets blurry. You stare at nothing for a little. You come back to.

[Your score has just gone up by three points.]

* * *

>scroll
EEEEER, EEEER, STOP STOP STOP, GSCH GSCH GSCH. Waaaackrrr ssshhhh... NOOOOO WHY WHY, WHY WHY

I'm starting to not feel so good.

[Your score has just gone up by ten points.]

>score
You have so far scored 16 out of a possible 0, in 7 turns.

>scroll
Wamp womp wamp womp... e e e, gir gir tir te..

>scroll
EEEEER, EEEER, STOP STOP STOP, GSCH GSCH GSCH. Waaaackrrr ssshhhh... NOOOOO WHY WHY, WHY WHY

I'm starting to not feel so good.

    *** You succumb. You stare at the walls around you and you fade. You get pulled in, you don't come back. You are now stuck. You never will experience anything else but this hell. You can't move, you can't think ***

In that game you scored 26 out of a possible 0, in 8 turns.

Would you like to RESTART, RESTORE a saved game, QUIT or UNDO the last command?

>restart
-------------------Important Info---------------------------

The score in the game is bad. Think of it as your sanity load. Get to high and something may happen.

You will need to know some commands, most commands are basic however here are two important ones:

Phone Down, and Phone Up. This is how you access the phone. The phone can only be used in the bedroom, it in itself is a room. Treat it as such and potentially explore it.

I think somethings wrong...
Something is wrong... by Luke Rowe
Release 1 / Serial number 230118 / Inform 7 v10.1.2 / D

Phone
You are on your phone, scrolling endlessly with no end in sight. You could possibly keep scrolling diving deeper into the void, the numbing of your mind.

A water main broke, leaving New Orleans without drinking water, and the flooding here is getting worse after waters from Lake Pontchartrain broke through a levee. 
 scroll 
 The Crips & Bloods tried to establish themselves here, and these guys killed them. Simple as that-gone! See you later! 
 scroll 
 Music Intro: Steve Lacy I wish I knew you wanted me I wish I knew, I wish I knew you wanted me I wish I knew, I wish I knew you wanted me 

Slowly you begin to hear a high pitch sound. You start feeling an unease. Maybe you should put the phone down.

Additionally you could continue to scroll. That feeling of unease could just be random. Go and see whats going on with your phone. What time was it again?

>dp
Bedroom
Your bedroom, the walls look kind of silly. Did the walls stucco always slide like that? Your bathroom is south of the Bedroom, the door to the outside to the east

You can see Bottle (in which is liquid) here.

 your head throbs, your vision gets blurry. You stare at nothing for a little. You come back to.

[Your score has just gone up by three points.]

>south
The Bathroom
Your bathroom, it seems kind of small. The corners of the room seem to be swaying inward. Other than that its a normal bathroom with a shower. Nothing special. I probably look like shit.

Self is a man sitting in your head, but your thoughts are jumbled

* * *

>scroll
Bwhahabbsahs. SCHHKKK... (catchy music) sssssssssssssssss...

I'm going insane i can't bare this anymore, please make it stop... I need to lay down, I need to do something. I can't do this, what am I doing. Something is off please let me out.
 You lose sight of what you are doing. You put your hands up and they look oddly distant. You say:

 Are these even my hands?

[Your score has just gone up by three points.]

>dp
Bedroom
Your bedroom, the walls look kind of silly. Did the walls stucco always slide like that? Your bathroom is south of the Bedroom, the closet is to the east, the door to the outside to the northeast

You can see Bottle (in which is liquid) here.

Let me out please let me out. I'm done with this... make it stop.

>look
Bedroom
Your bedroom, the walls look kind of silly. Did the walls stucco always slide like that? Your bathroom is south of the Bedroom, the door to the outside to the east

You can see Bottle (in which is liquid) here.

>look
Bedroom
Your bedroom, the walls look kind of silly. Did the walls stucco always slide like that? Your bathroom is south of the Bedroom, the door to the outside to the east

You can see Bottle (in which is liquid) here.

 You lose sight of what you are doing. You put your hands up and they look oddly distant. You say:

 Are these even my hands?

[Your score has just gone up by three points.]

>look
Bedroom
Your bedroom, the walls look kind of silly. Did the walls stucco always slide like that? Your bathroom is south of the Bedroom, the door to the outside to the east

You can see Bottle (in which is liquid) here.

 Your head throbs, your vision gets blurry. You stare at nothing for a little. You come back to.

    *** You succumb. You stare at the walls around you and you fade. You get pulled in, you don't come back. You are now stuck. You never will experience anything else but this hell. You can't move, you can't think ***

In that game you scored 21 out of a possible 0, in 7 turns.

Would you like to RESTART, RESTORE a saved game, QUIT or UNDO the last command?

* * *

>dp
Bedroom
Your bedroom, the walls look kind of silly. Did the walls stucco always slide like that? Your bathroom is south of the Bedroom, the closet is to the east, the door to the outside to the northeast

You can see Bottle (in which is liquid) here.

Let me out please let me out. I'm done with this... make it stop.

>east
Closet
Kinda running low on clothes... man everything is so outdated, I never get new clothes, I NEVER get anything good for myself, I think I have some things I can wear though...

You gaze at the corner of the closet and stare at how dark it is. Your gaze wanders across the clothing rack, then slowly throughout the rest of it. The felt and fabrics begin to seem like a mirage, fake almost... you get a ping. You snap back to.

You can see a Berserk Hoodie and a Black Joggers here.

Let me out please let me out. I'm done with this... make it stop.

* * *

>scroll
Wamp womp wamp womp... e e e, gir gir tir te..

 You lose sight of what you are doing. You put your hands up and they look oddly distant. You say:

 Are these even my hands?

[Your score has just gone up by three points.]

>dp
Bedroom
Your bedroom, the walls look kind of silly. Did the walls stucco always slide like that? Your bathroom is south of the Bedroom, the door to the outside to the east

You can see Bottle (in which is liquid) here.

 your head throbs, your vision gets blurry. You stare at nothing for a little. You come back to.

[Your score has just gone up by three points.]

>scroll
bruh

* * *

>dp
Bedroom
Your bedroom, the walls look kind of silly. Did the walls stucco always slide like that? Your bathroom is south of the Bedroom, the door to the outside to the east

You can see Bottle (in which is liquid) here.

 your head throbs, your vision gets blurry. You stare at nothing for a little. You come back to.

[Your score has just gone up by three points.]

>look
Bedroom
Your bedroom, the walls look kind of silly. Did the walls stucco always slide like that?

You can see Bottle (in which is liquid) here.

>take bottle
Taken.

 your head throbs, your vision gets blurry. You stare at nothing for a little. You come back to.

[Your score has just gone up by five points.]

* * *

>dp
Bedroom
Your bedroom, the walls look kind of silly. Did the walls stucco always slide like that? Your bathroom is south of the Bedroom, the door to the outside to the east

You can see Bottle (in which is liquid) here.

 your head throbs, your vision gets blurry. You stare at nothing for a little. You come back to.

[Your score has just gone up by three points.]

>south
Bathroom
Your bathroom, it seems kind of small. The corners of the room seem to be swaying inward. Other than that its a normal bathroom with a shower. Nothing special. I probably look like shit.

Self is a man sitting in your head, but your thoughts are jumbled

 your head throbs, your vision gets blurry. You stare at nothing for a little. You come back to.

[Your score has just gone up by three points.]

>shower
I feel much better after that. Things are starting to feel right again.

 your head throbs, your vision gets blurry. You stare at nothing for a little. You come back to.

[Your score has just gone down by seven points.]

>shower
I feel much better after that. Things are starting to feel right again.

[Your score has just gone down by ten points.]

>south
You can't go that way.

>north
You can't go that way.

>east
You can't go that way.

>west
You can't go that way.

* * *

>scroll
Wamp womp wamp womp... e e e, gir gir tir te..

>dp
Bedroom
Your bedroom, the walls look kind of silly. Did the walls stucco always slide like that?

You can see Bottle (in which is liquid) here.

 your head throbs, your vision gets blurry. You stare at nothing for a little. You come back to.

[Your score has just gone up by three points.]

>drink bottle
There's nothing suitable to drink here.

 your head throbs, your vision gets blurry. You stare at nothing for a little. You come back to.

[Your score has just gone up by three points.]

>take bottle
Taken.

>drink bottle
There's nothing suitable to drink here.

>drink liquid
You take a sip of the liquid. You feel a sense that it doesn't taste right... something isn't right... you start to feel illHey the headache is subsiding at least, something just doesn't feel right, your field of vision blurs for a second and comes back to
 your head throbs, your vision gets blurry. You stare at nothing for a little. You come back to.

[Your score has just gone up by one point.]

* * *

>scroll
Wamp womp wamp womp... e e e, gir gir tir te..

>down phone
Bedroom
Your bedroom, the walls look kind of silly. Did the walls stucco always slide like that? Your bathroom is south of the Bedroom, the door to the outside to the east

You can see Bottle (in which is liquid) here.

 your head throbs, your vision gets blurry. You stare at nothing for a little. You come back to.

[Your score has just gone up by three points.]

>x bottle
In Bottle is liquid.

>x liquid
Looks like water, smells like nothing... maybe  a little bit of metal? It looks off. Did the bottle always feel so heavy?

You look back up at your room there is a big blur and your eyes take time to readjust. You flop back into your bed as if picking up the bottle was too exhausting. You begin to get a headache.

* * *

>scroll
Wamp womp wamp womp... e e e, gir gir tir te..

>south
You can't go that way.

>south
You can't go that way.

>south
You can't go that way.

Your head throbs, your vision gets blurry. You stare at nothing for a little. You come back to.

[Your score has just gone up by three points.]

>south
You can't go that way.

I'm going insane i can't bare this anymore, please make it stop... I need to lay down, I need to do something. I can't do this, what am I doing. Something is off please let me out.

 You lose sight of what you are doing. You put your hands up and they look oddly distant. You say:  Are these even my hands?

[Your score has just gone up by three points.]

>east
You can't go that way.

Let me out please let me out. I'm done with this... make it stop.

>wear hoodie
You can't see any such thing.

>look
Phone
You are on your phone, scrolling endlessly with no end in sight.

A water main broke, leaving New Orleans without drinking water, and the flooding here is getting worse after waters from Lake Pontchartrain broke through a levee. 
 scroll 
 The Crips & Bloods tried to establish themselves here, and these guys killed them. Simple as that-gone! See you later! 
 scroll 
 Music Intro: Steve Lacy I wish I knew you wanted me I wish I knew, I wish I knew you wanted me I wish I knew, I wish I knew you wanted me 

Slowly you begin to hear a high pitch sound which you could listen to possibly. You start feeling an unease. Maybe you should put the phone down.

You could also stay on your phone in your endless lull.  scrolling, maybe that feeling of unease could just be random. Go and see whats going on with your phone.  What time was it again?

 I also have snapchat  I could open it but... there's no point, I don't ever get sent anything.

 You start with 5 sanity load

I can't do this... please stop this

Your head throbs, your vision gets blurry. You stare at nothing for a little. You come back to.

[Your score has just gone up by three points.]

>dp
Bedroom
Your bedroom, the walls look kind of silly. Did the walls stucco always slide like that? Your bathroom is south of the Bedroom, the closet is to the east, the door to the outside to the northeast

You can see Bottle (in which is liquid) here.

Let me out please let me out. I'm done with this... make it stop.

>east
closet
Kinda running low on clothes... man everything is so outdated, I never get new clothes, I NEVER get anything good for myself, I think I have some things I can wear though...

You gaze at the corner of the closet and stare at how dark it is. Your gaze wanders across the clothing rack, then slowly throughout the rest of it. The felt and fabrics begin to seem like a mirage, fake almost... you get a ping. You snap back to.

You can see a Berserk Hoodie and a Black Joggers here.

Let me out please let me out. I'm done with this... make it stop.

>wear hoodie
(first taking the Berserk Hoodie)
Let me out please let me out. I'm done with this... make it stop.

[Your score has just gone down by five points.]

>wear joggers
(first taking the Black Joggers)
[Your score has just gone down by five points.]

>score
You have so far scored 7 out of a possible 0, in 12 turns.

>west
Bedroom
Your bedroom, the walls look kind of silly. Did the walls stucco always slide like that? Your bathroom is south of the Bedroom, the closet is to the east, the door to the outside to the northeast

You can see Bottle (in which is liquid) here.

Your head throbs, your vision gets blurry. You stare at nothing for a little. You come back to.

[Your score has just gone up by three points.]

>north
You can't go that way.

>south
The Bathroom
Your bathroom, it seems kind of small. The corners of the room seem to be swaying inward. Other than that its a normal bathroom with a shower and a mirror that's refracting some weird looking objects. I probably look like shit.

Self is a man sitting in your head, but your thoughts are jumbled.

 You lose sight of what you are doing. You put your hands up and they look oddly distant. You say:  Are these even my hands?

[Your score has just gone up by three points.]

>shower
I feel much better after that. Things are starting to feel right again.

[Your score has just gone down by ten points.]

>shower
Okay okay, I think i'm looking better and feeling alright, no need to take another shower

Your head throbs, your vision gets blurry. You stare at nothing for a little. You come back to.

[Your score has just gone up by three points.]

>score
You have so far scored 6 out of a possible 0, in 17 turns.

>x mirror
Man I look horrible... why does my face look like that? I haven't taken a shower all day... I look like shit, I look like shit. There's something wrong with the perspective... I can't seem to make myself look right
I can't do this... please stop this
[Your score has just gone up by ten points.]

>talk to self
(Self)
What am I doing right now, why is everything so weird. Am I okay? What is happening?

Everything is going to be okay. I should try to do some things that will make me feel better.

Let me out please let me out. I'm done with this... make it stop.

* * *

>scrol
That's not a verb I recognise.

>scroll
Bwhahabbsahs. SCHHKKK... (catchy music) sssssssssssssssss...

>quit
Are you sure you want to quit?

* * *

>dp
Bedroom
Your bedroom, the walls look kind of silly. Did the walls stucco always slide like that? Your bathroom is south of the Bedroom, the closet is to the east, the door to the outside to the northeast

You can see Bottle (in which is liquid) here.

>take bottle
Taken.

* * *

>drink liquid
There's nothing suitable to drink here.

>drink
(Bottle)
There's nothing suitable to drink here.

>drink bottle
There's nothing suitable to drink here.

 your head throbs, your vision gets blurry. You stare at nothing for a little. You come back to.

[Your score has just gone up by three points.]

>drink
(Bottle)
There's nothing suitable to drink here.

>drink bottle
There's nothing suitable to drink here.

>x bottle
In Bottle is liquid.

>drink bottle
There's nothing suitable to drink here.

* * *

>dp
Bedroom
Your bedroom, the walls look kind of silly. Did the walls stucco always slide like that? Your bathroom is south of the Bedroom, the closet is to the east, the door to the outside to the northeast

You can see Bottle (in which is liquid) here.

>drink liquid
You take a sip of the liquid. You feel a sense that it doesn't taste right... something isn't right... you start to feel ill. 
Hey the headache is subsiding at least, something just doesn't feel right, your field of vision blurs for a second and comes back to
[Your score has just gone down by five points.]

>drink liquid
You take a sip of the liquid. You feel a sense that it doesn't taste right... something isn't right... you start to feel ill. 
Hey the headache is subsiding at least, something just doesn't feel right, your field of vision blurs for a second and comes back to
There's nothing suitable to drink here.

 your head throbs, your vision gets blurry. You stare at nothing for a little. You come back to.

[Your score has just gone up by one point.]

I beg your pardon?

>drink liquid
You take a sip of the liquid. You feel a sense that it doesn't taste right... something isn't right... you start to feel ill. 
Hey the headache is subsiding at least, something just doesn't feel right, your field of vision blurs for a second and comes back to
There's nothing suitable to drink here.

 your head throbs, your vision gets blurry. You stare at nothing for a little. You come back to.

[Your score has just gone up by one point.]

>drink liquid
You take a sip of the liquid. You feel a sense that it doesn't taste right... something isn't right... you start to feel ill. 
Hey the headache is subsiding at least, something just doesn't feel right, your field of vision blurs for a second and comes back to
There's nothing suitable to drink here.

 your head throbs, your vision gets blurry. You stare at nothing for a little. You come back to.

[Your score has just gone up by one point.]

* * *

>drink liquid
You take a sip of the liquid. You feel a sense that it doesn't taste right... something isn't right... you start to feel ill. 
Hey the headache is subsiding at least, something just doesn't feel right, your field of vision blurs for a second and comes back to
[Your score has just gone down by five points.]

I beg your pardon?

>drink liquid
You can't see any such thing.

>look
Bedroom
Your bedroom, the walls look kind of silly. Did the walls stucco always slide like that?

You can see Bottle (empty) here.

 your head throbs, your vision gets blurry. You stare at nothing for a little. You come back to.

[Your score has just gone up by three points.]

>look
Bedroom
Your bedroom, the walls look kind of silly. Did the walls stucco always slide like that?

You can see Bottle (empty) here.

* * *

>dp
Bedroom
Your bedroom, the walls look kind of silly. Did the walls stucco always slide like that? Your bathroom is south of the Bedroom, the closet is to the east, the door to the outside to the northeast

You can see Bottle (in which is liquid) here.

>x bottle
I wonder whats in here?

In Bottle is liquid.

>x bottle
I wonder whats in here

In Bottle is liquid.

 your head throbs, your vision gets blurry. You stare at nothing for a little. You come back to.

[Your score has just gone up by three points.]

>drink
(Bottle)
There's nothing suitable to drink here.

 your head throbs, your vision gets blurry. You stare at nothing for a little. You come back to.

[Your score has just gone up by three points.]

>take bottle
Taken.

>drink bottle
There's nothing suitable to drink here.

 your head throbs, your vision gets blurry. You stare at nothing for a little. You come back to.

[Your score has just gone up by three points.]

>drink liquid
You take a sip of the liquid. You feel a sense that it doesn't taste right... something isn't right... you start to feel ill. 
Hey the headache is subsiding at least, something just doesn't feel right, your field of vision blurs for a second and comes back to
[Your score has just gone down by five points.]

>look
Bedroom
Your bedroom, the walls look kind of silly. Did the walls stucco always slide like that? Your bathroom is south of the Bedroom, the door to the outside to the east

 your head throbs, your vision gets blurry. You stare at nothing for a little. You come back to.

[Your score has just gone up by three points.]

>east
I couldn't possibly go outside... I feel horrible, something isn't right

>south
The Bathroom
Your bathroom, it seems kind of small. The corners of the room seem to be swaying inward. Other than that its a normal bathroom with a shower. Nothing special. I probably look like shit.

Self is a man sitting in your head, but your thoughts are jumbled.

I beg your pardon?

>talk self
I didn't understand that sentence.

>talk to self
(Self)
What am I doing right now, why is everything so weird. Am I okay? What is happening?

Everything is going to be okay. I should try to do some things that will make me feel better.

>look
The Bathroom
Your bathroom, it seems kind of small. The corners of the room seem to be swaying inward. Other than that its a normal bathroom with a shower. Nothing special. I probably look like shit.

Self is a man sitting in your head, but your thoughts are jumbled.

 your head throbs, your vision gets blurry. You stare at nothing for a little. You come back to.

[Your score has just gone up by three points.]

I beg your pardon?

>x mirror
Man I look horrible... why does my face look like that? I haven't taken a shower all day... I look like shit, I look like shit. There's something wrong with the perspective... I can't seem to make myself look right

    *** You succumb. You stare at the walls around you and you fade. You get pulled in, you don't come back. You are now stuck. You never will experience anything else but this hell. You can't move, you can't think ***

In that game you scored 26 out of a possible 0, in 13 turns.

Would you like to RESTART, RESTORE a saved game, QUIT or UNDO the last command?

>restart
-------------------Important Info---------------------------

The score in the game is bad. Think of it as your sanity load. Get to high and something may happen.

You will need to know some commands, most commands are basic however here are two important ones:

Phone Down, and Phone Up. This is how you access the phone. The phone can only be used in the bedroom, it in itself is a room. Treat it as such and potentially explore it.

-------------------Begin--------------------------- 
I think somethings wrong...
Something is wrong... by Luke Rowe
Release 1 / Serial number 230118 / Inform 7 v10.1.2 / D

Phone
You are on your phone, scrolling endlessly with no end in sight. You could possibly keep scrolling diving deeper into the void, the numbing of your mind.

A water main broke, leaving New Orleans without drinking water, and the flooding here is getting worse after waters from Lake Pontchartrain broke through a levee. 
 scroll 
 The Crips & Bloods tried to establish themselves here, and these guys killed them. Simple as that-gone! See you later! 
 scroll 
 Music Intro: Steve Lacy I wish I knew you wanted me I wish I knew, I wish I knew you wanted me I wish I knew, I wish I knew you wanted me 

Slowly you begin to hear a high pitch sound. You start feeling an unease. Maybe you should put the phone down.

Additionally you could continue to scroll. That feeling of unease could just be random. Go and see whats going on with your phone. What time was it again?

>dp
Bedroom
Your bedroom, the walls look kind of silly. Did the walls stucco always slide like that? Your bathroom is south of the Bedroom, the door to the outside to the east

You can see Bottle (in which is liquid) here.

>south
The Bathroom
Your bathroom, it seems kind of small. The corners of the room seem to be swaying inward. Other than that its a normal bathroom with a shower. Nothing special. I probably look like shit.

Self is a man sitting in your head, but your thoughts are jumbled.

>x self
(Self)
talking to myself could help a bit... maybe I can figure out what is going on.

>x mirror
Man I look horrible... why does my face look like that? I haven't taken a shower all day... I look like shit, I look like shit. There's something wrong with the perspective... I can't seem to make myself look right
[Your score has just gone up by ten points.]

>shower
I feel much better after that. Things are starting to feel right again.

[Your score has just gone down by ten points.]

* * *

>x bottle
I wonder whats in here?

In Bottle is liquid.

>drink liquid
You take a sip of the liquid. You feel a sense that it doesn't taste right... something isn't right... you start to feel ill. 
Hey the headache is subsiding at least, something just doesn't feel right, your field of vision blurs for a second and comes back to
[Your score has just gone down by five points.]

* * *

>dp
Bedroom
Your bedroom, the walls look kind of silly. Did the walls stucco always slide like that? Your bathroom is south of the Bedroom, the closet is to the east, the door to the outside to the northeast

You can see Bottle (in which is liquid) here.

>score
You have so far scored 8 out of a possible 0, in 2 turns.

* * *

>dp
Bedroom
Your bedroom, the walls look kind of silly. Did the walls stucco always slide like that? Your bathroom is south of the Bedroom, the closet is to the east, the door to the outside to the northeast

You can see Bottle (in which is liquid) here.

>look
Bedroom
Your bedroom, the walls look kind of silly. Did the walls stucco always slide like that? Your bathroom is south of the Bedroom, the door to the outside to the east

You can see Bottle (in which is liquid) here.

>x bottle
I wonder whats in here?

In Bottle is liquid.

>x liquid
Looks like water, smells like nothing... maybe  a little bit of metal? It looks off. Did the bottle always feel so heavy?

You look back up at your room there is a big blur and your eyes take time to readjust. You flop back into your bed as if picking up the bottle was too exhausting. You begin to get a headache. Should I drink the liquid? It still feels wrong.

>drink liquid
You take a sip of the liquid. You feel a sense that it doesn't taste right... something isn't right... you start to feel ill. 
Hey the headache is subsiding at least, something just doesn't feel right, your field of vision blurs for a second and comes back to
 You lose sight of what you are doing. You put your hands up and they look oddly distant. You say:

 Are these even my hands?

[Your score has just gone down by two points.]

* * *

>dp
Bedroom
Your bedroom, the walls look kind of silly. Did the walls stucco always slide like that? Your bathroom is south of the Bedroom, the closet is to the east, the door to the outside to the northeast

You can see Bottle (in which is liquid) here.

>northeast
I couldn't possibly go outside... I feel horrible, something isn't right, something isn't right.

>east
Closet
Kinda running low on clothes... man everything is so outdated, I think I have some things I can wear though...

You gaze at the corner of the closet and stare at how dark it is. Your gaze wanders across the clothing rack, then slowly throughout the rest of it. The felt and fabrics begin to seem like a mirage, fake almost... you get a ping. You snap back to.

>x clothing rcak
I only understood you as far as wanting to examine the clothing rack.

>x clothing rack
On the clothing rack is your favorite Berserk hoodie. You're comfy joggers. And a bunch of other misc. clothing

>x rack
On the clothing rack is your favorite Berserk hoodie. You're comfy joggers. And a bunch of other misc. clothing

>x clothing
On the clothing rack is your favorite Berserk hoodie. You're comfy joggers. And a bunch of other misc. clothing

* * *

>dp
Bedroom
Your bedroom, the walls look kind of silly. Did the walls stucco always slide like that? Your bathroom is south of the Bedroom, the closet is to the east, the door to the outside to the northeast

You can see Bottle (in which is liquid) here.

>ne
I couldn't possibly go outside... I feel horrible, something isn't right, something isn't right.

>e
Closet
Kinda running low on clothes... man everything is so outdated, I never get new clothes, I NEVER get anything good for myself, I think I have some things I can wear though...

You gaze at the corner of the closet and stare at how dark it is. Your gaze wanders across the clothing rack, then slowly throughout the rest of it. The felt and fabrics begin to seem like a mirage, fake almost... you get a ping. You snap back to.

>x
(the clothing rack)
On the clothing rack is your favorite Berserk hoodie. You're comfy joggers. And a bunch of other misc. clothing you couldn't give a shit less about.

>wear hoodie
You can't see any such thing.

>wear berserk hoodie
You can't see any such thing.

* * *

>dp
Bedroom
Your bedroom, the walls look kind of silly. Did the walls stucco always slide like that? Your bathroom is south of the Bedroom, the closet is to the east, the door to the outside to the northeast

You can see Bottle (in which is liquid) here.

>east
Closet
Kinda running low on clothes... man everything is so outdated, I never get new clothes, I NEVER get anything good for myself, I think I have some things I can wear though...

You gaze at the corner of the closet and stare at how dark it is. Your gaze wanders across the clothing rack, then slowly throughout the rest of it. The felt and fabrics begin to seem like a mirage, fake almost... you get a ping. You snap back to.

You can see a Berserk Hoodie and a Black Joggers here.

>x hoodie
Black with a couple of white Manga frames printed on. You think to yourself, "shit goes hard".

>x joggers
You can't see any such thing.

>x black joggers
You can't see any such thing.

* * *

>east
Closet
Kinda running low on clothes... man everything is so outdated, I never get new clothes, I NEVER get anything good for myself, I think I have some things I can wear though...

You gaze at the corner of the closet and stare at how dark it is. Your gaze wanders across the clothing rack, then slowly throughout the rest of it. The felt and fabrics begin to seem like a mirage, fake almost... you get a ping. You snap back to.

You can see a Berserk Hoodie and a Black Joggers here.

>wear hoodie
(first taking the Berserk Hoodie)
You put on the Berserk Hoodie.

 You lose sight of what you are doing. You put your hands up and they look oddly distant. You say:

 Are these even my hands?

[Your score has just gone up by three points.]

>take off hoodie
You take off the Berserk Hoodie.

>wear hoodie
You put on the Berserk Hoodie.

I beg your pardon?

>wear hoodie
You're already wearing that!

>take off hoodie
You take off the Berserk Hoodie.

* * *

>east
Closet
Kinda running low on clothes... man everything is so outdated, I never get new clothes, I NEVER get anything good for myself, I think I have some things I can wear though...

You gaze at the corner of the closet and stare at how dark it is. Your gaze wanders across the clothing rack, then slowly throughout the rest of it. The felt and fabrics begin to seem like a mirage, fake almost... you get a ping. You snap back to.

You can see a Berserk Hoodie and a Black Joggers here.

>wear jogger
You can't see any such thing.

>wear joggers
(first taking the Black Joggers)
[Your score has just gone down by five points.]

* * *

>east
Closet
Kinda running low on clothes... man everything is so outdated, I never get new clothes, I NEVER get anything good for myself, I think I have some things I can wear though...

You gaze at the corner of the closet and stare at how dark it is. Your gaze wanders across the clothing rack, then slowly throughout the rest of it. The felt and fabrics begin to seem like a mirage, fake almost... you get a ping. You snap back to.

You can see a Berserk Hoodie and a Black Joggers here.

>berserk hoodie
That's not a verb I recognise.

>x berserk hoodie
Black with a couple of white Manga frames printed on. You think to yourself, "shit goes hard".

>wear hoodie
(first taking the Berserk Hoodie)
 Your head throbs, your vision gets blurry. You stare at nothing for a little. You come back to.

[Your score has just gone down by two points.]

>x joggers
Black with white speckles. They have a hole in it but they are your favorite and feel so nice and make go good with the hoodie.

 You lose sight of what you are doing. You put your hands up and they look oddly distant. You say:

 Are these even my hands?

[Your score has just gone up by three points.]

>wear joggers
(first taking the Black Joggers)
[Your score has just gone down by five points.]

>take off joggers
I'm such a schizo, I can't make up my mind. This doesn't feel right... what's wrong with me. I cant even put some clothes on.

 You lose sight of what you are doing. You put your hands up and they look oddly distant. You say:

 Are these even my hands?

[Your score has just gone up by nine points.]

>score
You have so far scored 10 out of a possible 0, in 8 turns.

>score
You have so far scored 10 out of a possible 0, in 8 turns.

>listen
This sound isn't real, it doesn't exist, its so irritating I can't stand it... why can't it stop.

[Your score has just gone up by three points.]

>score
You have so far scored 13 out of a possible 0, in 9 turns.

>listen
This sound isn't real, it doesn't exist, its so irritating I can't stand it... why can't it stop.

[Your score has just gone up by three points.]

>listen
This sound isn't real, it doesn't exist, its so irritating I can't stand it... why can't it stop.

    *** You took too long, you did the things you knew would make you worse off. You succumb. You stare at the walls around you and you fade. You get pulled in, you don't come back. You are now stuck. You never will experience anything else but this hell. You can't move, you can't think ***

In that game you scored 19 out of a possible 0, in 10 turns.

Would you like to RESTART, RESTORE a saved game, QUIT or UNDO the last command?

* * *

>dp
Bedroom
Your bedroom, the walls look kind of silly. Did the walls stucco always slide like that? Your bathroom is south of the Bedroom, the closet is to the east, the door to the outside to the northeast

You can see Bottle (in which is liquid) here.

>south
The Bathroom
Your bathroom, it seems kind of small. The corners of the room seem to be swaying inward. Other than that its a normal bathroom with a shower and a mirror that's refracting some weird looking objects. I probably look like shit.

Self is a man sitting in your head, but your thoughts are jumbled.

>1
She looks interested.

 You lose sight of what you are doing. You put your hands up and they look oddly distant. You say:  Are these even my hands?

[Your score has just gone up by three points.]

* * *

>south
The Bathroom
Your bathroom, it seems kind of small. The corners of the room seem to be swaying inward. Other than that its a normal bathroom with a shower and a mirror that's refracting some weird looking objects. I probably look like shit.

Self is a man sitting in your head, but your thoughts are jumbled.

>no
No it's not, it never is, this always happens... I always come back to this... Why me, why is this happening right now I can't escape.

 You lose sight of what you are doing. You put your hands up and they look oddly distant. You say:  Are these even my hands?

[Your score has just gone up by six points.]

>no
Saying the same things over and over isn't gonna make me feel better
I'm going insane i can't bare this anymore, please make it stop... I need to lay down, I need to do something. I can't do this, what am I doing. Something is off please let me out.

>yes
Your right... just go with the flow.

Your head throbs, your vision gets blurry. You stare at nothing for a little. You come back to.

[Your score has just gone down by one point.]

>yes
Saying the same things over and over isn't gonna make me feel better

 You lose sight of what you are doing. You put your hands up and they look oddly distant. You say:  Are these even my hands?

[Your score has just gone up by three points.]

>3
Just focus on doing something productive, the less I think about this the better

Your head throbs, your vision gets blurry. You stare at nothing for a little. You come back to.

[Your score has just gone down by one point.]

>3
Saying the same things over and over isn't gonna make me feel better
Let me out please let me out. I'm done with this... make it stop.

 You lose sight of what you are doing. You put your hands up and they look oddly distant. You say:  Are these even my hands?

[Your score has just gone up by three points.]

>3
Saying the same things over and over isn't gonna make me feel better
Let me out please let me out. I'm done with this... make it stop.

 You lose sight of what you are doing. You put your hands up and they look oddly distant. You say:  Are these even my hands?

[Your score has just gone up by three points.]

>3
Saying the same things over and over isn't gonna make me feel better
Let me out please let me out. I'm done with this... make it stop.

>3
Saying the same things over and over isn't gonna make me feel better
I can't do this... please stop this

>3
Saying the same things over and over isn't gonna make me feel better
I can't do this... please stop this

>3
Saying the same things over and over isn't gonna make me feel better
Let me out please let me out. I'm done with this... make it stop.

* * *

>3
Saying the same things over and over isn't gonna make me feel better
I can't do this... please stop this

I beg your pardon?

>g
Saying the same things over and over isn't gonna make me feel better
I can't do this... please stop this

>g
Saying the same things over and over isn't gonna make me feel better
I can't do this... please stop this

 You lose sight of what you are doing. You put your hands up and they look oddly distant. You say:  Are these even my hands?

    *** You took too long, you did the things you knew would make you worse off. You succumb. You stare at the walls around you and you fade. You get pulled in, you don't come back. You are now stuck. You never will experience anything else but this hell. You can't move, you can't think ***

In that game you scored 21 out of a possible 0, in 20 turns.

Would you like to RESTART, RESTORE a saved game, QUIT or UNDO the last command?

>restart
-------------------Important Info---------------------------

 Starting there is  TW for mental health related topics. This game is a game about disassociation and could be a trigger for some. 

The score in the game is your sanity/ self image. You start with 5, and can check it with score. Get too high and something bad may happen. In other words try to get a low score. Another part of the scoring is that you will consistently take damage to your sanity, sometimes even when you do something good you'll be punished because you got another one of those pings... it sucks, I know.

You will need to know a special part of this game, that is the phone. The phone is a room not an object so treat it as such. Throughout the game text will be highlighted... this may mean you can interact with typing it out ;)

-------------------Begin--------------------------- 
I think somethings wrong...
Something is wrong... by Luke Rowe
Release 1 / Serial number 230123 / Inform 7 v10.1.2 / D

Phone
You are on your phone, scrolling endlessly with no end in sight.

A water main broke, leaving New Orleans without drinking water, and the flooding here is getting worse after waters from Lake Pontchartrain broke through a levee. 
 scroll 
 The Crips & Bloods tried to establish themselves here, and these guys killed them. Simple as that-gone! See you later! 
 scroll 
 Music Intro: Steve Lacy I wish I knew you wanted me I wish I knew, I wish I knew you wanted me I wish I knew, I wish I knew you wanted me 

Slowly you begin to hear a high pitch sound which you could listen to possibly. You start feeling an unease. Maybe you should put the phone down.

You could also stay on your phone in your endless lull.  scrolling, maybe that feeling of unease could just be random. Go and see whats going on with your phone.  What time was it again?

 I also have snapchat  I could open it but... there's no point, I don't ever get sent anything.

 You start with 5 sanity load

>dp
Bedroom
Your bedroom, the walls look kind of silly. Did the walls stucco always slide like that? Your bathroom is south of the Bedroom, the closet is to the east, the door to the outside to the northeast

You can see Bottle (in which is liquid) here.

Your head throbs, your vision gets blurry. You stare at nothing for a little. You come back to.

[Your score has just gone up by three points.]

>south
The Bathroom
Your bathroom, it seems kind of small. The corners of the room seem to be swaying inward. Other than that its a normal bathroom with a shower and a mirror that's refracting some weird looking objects. I probably look like shit.

Self is a man sitting in your head, but your thoughts are jumbled.

>1
Your right... just go with the flow.

[Your score has just gone down by four points.]

>3
Just focus on doing something productive, the less I think about this the better
[Your score has just gone down by four points.]

>score
You have so far scored 0 out of a possible 0, in 5 turns.

* * *

>south
The Bathroom
Your bathroom, it seems kind of small. The corners of the room seem to be swaying inward. Other than that its a normal bathroom with a shower and a mirror that's refracting some weird looking objects. I probably look like shit.

Self is a man sitting in your head, but your thoughts are jumbled.

>talk to self
(Self)
What am I doing right now, why is everything so weird. Am I okay? What is happening?

1. Things don't always seem wrong. Somethings just up right now. 2. Everything is going to be okay. 3. I should try to do some things that will make me feel better.

* * *

>dp
Bedroom
Your bedroom, the walls look kind of silly. Did the walls stucco always slide like that? Your bathroom is south of the Bedroom, the closet is to the east, the door to the outside to the northeast

You can see Bottle (in which is liquid) here.

>north
You can't go that way.

Your head throbs, your vision gets blurry. You stare at nothing for a little. You come back to.

[Your score has just gone up by three points.]

>south
The Bathroom
Your bathroom, it seems kind of small. The corners of the room seem to be swaying inward. Other than that its a normal bathroom with a shower and a mirror that's refracting some weird looking objects. I probably look like shit.

Self is a man sitting in your head, but your thoughts are jumbled.

 You lose sight of what you are doing. You put your hands up and they look oddly distant. You say:  Are these even my hands?

[Your score has just gone up by three points.]

>1
Your right... just go with the flow.

[Your score has just gone down by four points.]

>1
Saying the same things over and over isn't gonna make me feel better

* * *

>look
Phone
You are on your phone, scrolling endlessly with no end in sight. You could possibly keep scrolling diving deeper into the void, the numbing of your mind.

A water main broke, leaving New Orleans without drinking water, and the flooding here is getting worse after waters from Lake Pontchartrain broke through a levee. 
 scroll 
 The Crips & Bloods tried to establish themselves here, and these guys killed them. Simple as that-gone! See you later! 
 scroll 
 Music Intro: Steve Lacy I wish I knew you wanted me I wish I knew, I wish I knew you wanted me I wish I knew, I wish I knew you wanted me 

Slowly you begin to hear a high pitch sound. You start feeling an unease. Maybe you should put the phone down.

Additionally you could continue to scroll. That feeling of unease could just be random. Go and see whats going on with your phone.

>scroll
Wamp womp wamp womp... e e e, gir gir tir te..

>scroll
EEEEER, EEEER, STOP STOP STOP, GSCH GSCH GSCH. Waaaackrrr ssshhhh... NOOOOO WHY WHY, WHY WHYIm starting to get not feel good
 your head throbs, your vision gets blurry. You stare at nothing for a little. You come back to.

[Your score has just gone up by thirteen points.]

* * *

>shower
Take a shower, why would I do that, i'm just sitting here and things aren't feeling right, it seems like the last thing I want to do. It's just not right

>dp
Bedroom
Your bedroom, the walls look kind of silly. Did the walls stucco always slide like that? Your bathroom is south of the Bedroom, the door to the outside to the east

You can see Bottle (in which is liquid) here.

>south
Bathroom
Your bathroom, it seems kind of small. The corners of the room seem to be swaying inward. Other than that its a normal bathroom with a shower. Nothing special. I probably look like shit.

Your thoughts are jumbled

 your head throbs, your vision gets blurry. You stare at nothing for a little. You come back to.

[Your score has just gone up by three points.]

>shower
I feel much better after that. Things are starting to feel right again.

[Your score has just gone down by ten points.]

>talk to self
That's not a verb I recognise.

>look
Bathroom
Your bathroom, it seems kind of small. The corners of the room seem to be swaying inward. Other than that its a normal bathroom with a shower. Nothing special. I probably look like shit.

Your thoughts are jumbled

>x self
(Self)
talking to myself could help a bit... maybe I can figure out what is going o.

 your head throbs, your vision gets blurry. You stare at nothing for a little. You come back to.

[Your score has just gone up by three points.]

I beg your pardon?

* * *

>check the time
The time is 12:13, it way to early for this to be happening. Normally it's only at night this happens... what am I doing
 your head throbs, your vision gets blurry. You stare at nothing for a little. You come back to.

[Your score has just gone up by six points.]

>room
That's not a verb I recognise.

I beg your pardon?

>dp
Bedroom
Your bedroom, the walls look kind of silly. Did the walls stucco always slide like that? Your bathroom is south of the Bedroom, the door to the outside to the east

You can see Bottle (in which is liquid) here.

>check the time
The time? What about it, it's probably late... too late... what am I even doing right now I don't have my phone, i'm stupid what does it even matter.

 your head throbs, your vision gets blurry. You stare at nothing for a little. You come back to.

[Your score has just gone up by nine points.]

>south
The Bathroom
Your bathroom, it seems kind of small. The corners of the room seem to be swaying inward. Other than that its a normal bathroom with a shower. Nothing special. I probably look like shit.

Self is a man sitting in your head, but your thoughts are jumbled

>talk to self
(Self)
What am I doing right now, why is everything so weird. Am I okay? What is happening?

Everything is going to be okay. I should try to do some things that will make me feel better.

* * *

>talk to self
(Self)
What am I doing right now, why is everything so weird. Am I okay? What is happening?

Everything is going to be okay. I should try to do some things that will make me feel better.

 your head throbs, your vision gets blurry. You stare at nothing for a little. You come back to.

[Your score has just gone up by three points.]

>talk to self
(Self)
What am I doing right now, why is everything so weird. Am I okay? What is happening?

Everything is going to be okay. I should try to do some things that will make me feel better.

 your head throbs, your vision gets blurry. You stare at nothing for a little. You come back to.

[Your score has just gone up by three points.]

>score
You have so far scored 21 out of a possible 0, in 8 turns.

>talk to self
(Self)
What am I doing right now, why is everything so weird. Am I okay? What is happening?

Everything is going to be okay. I should try to do some things that will make me feel better.

* * *

>check time
The time is 12:13, it way to early for this to be happening. Normally it's only at night this happens... what am I doing
[Your score has just gone up by three points.]

>check time
The time is 12:13, it way to early for this to be happening. Normally it's only at night this happens... what am I doing
[Your score has just gone up by three points.]

>score
You have so far scored 9 out of a possible 0, in 3 turns.

>scroll
Wamp womp wamp womp... e e e, gir gir tir te..

>scroll
EEEEER, EEEER, STOP STOP STOP, GSCH GSCH GSCH. Waaaackrrr ssshhhh... NOOOOO WHY WHY, WHY WHY

I'm starting to not feel so good.

[Your score has just gone up by ten points.]

>score
You have so far scored 19 out of a possible 0, in 5 turns.

* * *

>check time
The time is 12:13, it way to early for this to be happening. Normally it's only at night this happens... what am I doing
[Your score has just gone up by three points.]

>scroll
Bwhahabbsahs. SCHHKKK... (catchy music) sssssssssssssssss...

 your head throbs, your vision gets blurry. You stare at nothing for a little. You come back to.

[Your score has just gone up by three points.]

* * *

>scroll
Bwhahabbsahs. SCHHKKK... (catchy music) sssssssssssssssss...

>scroll
Wamp womp wamp womp... e e e, gir gir tir te..

>scroll
Bwhahabbsahs. SCHHKKK... (catchy music) sssssssssssssssss...

 your head throbs, your vision gets blurry. You stare at nothing for a little. You come back to.

[Your score has just gone up by three points.]

>scroll
EEEEER, EEEER, STOP STOP STOP, GSCH GSCH GSCH. Waaaackrrr ssshhhh... NOOOOO WHY WHY, WHY WHY

I'm starting to not feel so good.

You succumb. You stare at the walls around you and you fade. You get pulled in, you don't come back. You are now stuck. You never will experience anything else but this hell. You can't move, you can't think
[Your score has just gone up by ten points.]

>score
You have so far scored 19 out of a possible 0, in 7 turns.

>scroll
Wamp womp wamp womp... e e e, gir gir tir te..

You succumb. You stare at the walls around you and you fade. You get pulled in, you don't come back. You are now stuck. You never will experience anything else but this hell. You can't move, you can't think

* * *

>snapchat
That's not a verb I recognise.

>x snapchat
Hey my girlfriend sent me something, it says:

Can I come over tonight? I can drive you to school tomorrow if you'd like :)

That was nice, I wish she could but I feel like shit right now... I gotta get in better shape.

[Your score has just gone down by five points.]

>x snapchat
No point in checking snap again, I already checked all the messages... no one other than my girlfriend every texts me
[Your score has just gone down by one point.]

* * *

>scrolling
That's not a verb I recognise.

>scroll
EEEEER, EEEER, STOP STOP STOP, GSCH GSCH GSCH. Waaaackrrr ssshhhh... NOOOOO WHY WHY, WHY WHY

I'm starting to not feel so good.

[Your score has just gone up by ten points.]

>snapchat
That's not a verb I recognise.

* * *

>x snapchat
Hey my girlfriend sent me something, it says:

Can I come over tonight? I can drive you to school tomorrow if you'd like :)

That was nice, I wish she could but I feel like shit right now... I gotta get in better shape.

[Your score has just gone down by five points.]

>x time
The time is 12:13, it way to early for this to be happening. Normally it's only at night this happens... what am I doing
[Your score has just gone up by three points.]

>time
The time is 12:13, it way to early for this to be happening. Normally it's only at night this happens... what am I doing
[Your score has just gone up by three points.]

>look
Phone
You are on your phone, scrolling endlessly with no end in sight.

A water main broke, leaving New Orleans without drinking water, and the flooding here is getting worse after waters from Lake Pontchartrain broke through a levee. 
 scroll 
 The Crips & Bloods tried to establish themselves here, and these guys killed them. Simple as that-gone! See you later! 
 scroll 
 Music Intro: Steve Lacy I wish I knew you wanted me I wish I knew, I wish I knew you wanted me I wish I knew, I wish I knew you wanted me 

Slowly you begin to hear a high pitch sound. You start feeling an unease. Maybe you should put the phone down.

You could also stay on your phone in your endless lull.  scrolling , maybe that feeling of unease could just be random. Go and see whats going on with your phone.  What time was it again?

 I also have snapchat  I could go to... not really  a point probably.

 You start with 5 sanity load

>dp
Bedroom
Your bedroom, the walls look kind of silly. Did the walls stucco always slide like that? Your bathroom is south of the Bedroom, the door to the outside to the east

You can see Bottle (in which is liquid) here.

>x bottle
I wonder whats in here?

In Bottle is liquid.

>x liquid
Looks like water, smells like nothing... maybe  a little bit of metal? It looks off. Did the bottle always feel so heavy?

You look back up at your room there is a big blur and your eyes take time to readjust. You flop back into your bed as if picking up the bottle was too exhausting. You begin to get a headache.

>drink liquid
You take a sip of the liquid. You feel a sense that it doesn't taste right... something isn't right... you start to feel ill. 
Hey the headache is subsiding at least, something just doesn't feel right, your field of vision blurs for a second and comes back to
[Your score has just gone down by five points.]

>x liquid
You can't see any such thing.

>restart
Are you sure you want to restart?

>yes
-------------------Important Info---------------------------

The score in the game is bad. Think of it as your sanity load. Get to high and something may happen.

You will need to know some commands, most commands are basic however here are two important ones:

Phone Down, and Phone Up. This is how you access the phone. The phone can only be used in the bedroom, it in itself is a room. Treat it as such and potentially explore it.

-------------------Begin--------------------------- 
I think somethings wrong...
Something is wrong... by Luke Rowe
Release 1 / Serial number 230118 / Inform 7 v10.1.2 / D

Phone
You are on your phone, scrolling endlessly with no end in sight.

A water main broke, leaving New Orleans without drinking water, and the flooding here is getting worse after waters from Lake Pontchartrain broke through a levee. 
 scroll 
 The Crips & Bloods tried to establish themselves here, and these guys killed them. Simple as that-gone! See you later! 
 scroll 
 Music Intro: Steve Lacy I wish I knew you wanted me I wish I knew, I wish I knew you wanted me I wish I knew, I wish I knew you wanted me 

Slowly you begin to hear a high pitch sound. You start feeling an unease. Maybe you should put the phone down.

You could also stay on your phone in your endless lull.  scrolling , maybe that feeling of unease could just be random. Go and see whats going on with your phone.  What time was it again?

 I also have snapchat  I could go to... not really  a point probably.

 You start with 5 sanity load

>dp
Bedroom
Your bedroom, the walls look kind of silly. Did the walls stucco always slide like that? Your bathroom is south of the Bedroom, the door to the outside to the east

You can see Bottle (in which is liquid) here.

>x liquid
Looks like water, smells like nothing... maybe  a little bit of metal? It looks off. Did the bottle always feel so heavy?

You look back up at your room there is a big blur and your eyes take time to readjust. You flop back into your bed as if picking up the bottle was too exhausting. You begin to get a headache.

* * *

>drink liquid
You take a sip of the liquid. You feel a sense that it doesn't taste right... something isn't right... you start to feel ill. 
Hey the headache is subsiding at least, something just doesn't feel right, your field of vision blurs for a second and comes back to
[Your score has just gone down by five points.]

>south
The Bathroom
Your bathroom, it seems kind of small. The corners of the room seem to be swaying inward. Other than that its a normal bathroom with a shower. Nothing special. I probably look like shit.

Self is a man sitting in your head, but your thoughts are jumbled.

>x mirror
Man I look horrible... why does my face look like that? I haven't taken a shower all day... I look like shit, I look like shit. There's something wrong with the perspective... I can't seem to make myself look right
[Your score has just gone up by ten points.]

* * *

>north
Bedroom
Your bedroom, the walls look kind of silly. Did the walls stucco always slide like that? Your bathroom is south of the Bedroom, the door to the outside to the east

You can see Bottle (empty) here.

>east
    *** You made it outside... things start to feel right, you see your friend and talk with them. Your phone stops being so cryptic and you see a message from your girlfriend. You feel relief and you continue your day ***

In that game you scored -10 out of a possible 0, in 9 turns.

Would you like to RESTART, RESTORE a saved game, QUIT or UNDO the last command?

>restart
-------------------Important Info---------------------------

The score in the game is bad. Think of it as your sanity load. Get to high and something may happen.

You will need to know some commands, most commands are basic however here are two important ones:

Phone Down, and Phone Up. This is how you access the phone. The phone can only be used in the bedroom, it in itself is a room. Treat it as such and potentially explore it.

-------------------Begin--------------------------- 
I think somethings wrong...
Something is wrong... by Luke Rowe
Release 1 / Serial number 230118 / Inform 7 v10.1.2 / D

Phone
You are on your phone, scrolling endlessly with no end in sight.

A water main broke, leaving New Orleans without drinking water, and the flooding here is getting worse after waters from Lake Pontchartrain broke through a levee. 
 scroll 
 The Crips & Bloods tried to establish themselves here, and these guys killed them. Simple as that-gone! See you later! 
 scroll 
 Music Intro: Steve Lacy I wish I knew you wanted me I wish I knew, I wish I knew you wanted me I wish I knew, I wish I knew you wanted me 

Slowly you begin to hear a high pitch sound. You start feeling an unease. Maybe you should put the phone down.

You could also stay on your phone in your endless lull.  scrolling , maybe that feeling of unease could just be random. Go and see whats going on with your phone.  What time was it again?

 I also have snapchat  I could go to... not really  a point probably.

 You start with 5 sanity load

>dp
Bedroom
Your bedroom, the walls look kind of silly. Did the walls stucco always slide like that? Your bathroom is south of the Bedroom, the door to the outside to the east

You can see Bottle (in which is liquid) here.

 Your head throbs, your vision gets blurry. You stare at nothing for a little. You come back to.

[Your score has just gone up by three points.]

>east
I couldn't possibly go outside... I feel horrible, something isn't right

* * *

>listen
This sound isn't real, it doesn't exist, its so irritating I can't stand it... why can't it stop.

[Your score has just gone up by three points.]

>listen
This sound isn't real, it doesn't exist, its so irritating I can't stand it... why can't it stop.

[Your score has just gone up by three points.]

>listen to the sound
You can't see any such thing.

* * *

>phone down
Bedroom
Your bedroom, the walls look kind of silly. Did the walls stucco always slide like that? Your bathroom is south of the Bedroom, the door to the outside to the east

You can see Bottle (in which is liquid) here.

>phone up
Phone
You are on your phone, scrolling endlessly with no end in sight.

A water main broke, leaving New Orleans without drinking water, and the flooding here is getting worse after waters from Lake Pontchartrain broke through a levee. 
 scroll 
 The Crips & Bloods tried to establish themselves here, and these guys killed them. Simple as that-gone! See you later! 
 scroll 
 Music Intro: Steve Lacy I wish I knew you wanted me I wish I knew, I wish I knew you wanted me I wish I knew, I wish I knew you wanted me 

Slowly you begin to hear a high pitch sound which you could listen to possibly. You start feeling an unease. Maybe you should put the phone down.

You could also stay on your phone in your endless lull.  scrolling, maybe that feeling of unease could just be random. Go and see whats going on with your phone.  What time was it again?

 I also have snapchat  I could open it but... there's no point, I don't ever get sent anything.

 You start with 5 sanity load

>phone down
Bedroom
Your bedroom, the walls look kind of silly. Did the walls stucco always slide like that? Your bathroom is south of the Bedroom, the door to the outside to the east

You can see Bottle (in which is liquid) here.

 You lose sight of what you are doing. You put your hands up and they look oddly distant. You say:

 Are these even my hands?

[Your score has just gone up by three points.]

>x bottle
I wonder whats in here?

In Bottle is liquid.

>x liquid
Looks like water, smells like nothing... maybe  a little bit of metal? It looks off. Did the bottle always feel so heavy?

You look back up at your room there is a big blur and your eyes take time to readjust. You flop back into your bed as if picking up the bottle was too exhausting. You begin to get a headache.

 Your head throbs, your vision gets blurry. You stare at nothing for a little. You come back to.

[Your score has just gone up by three points.]

>drink
(Bottle)
There's nothing suitable to drink here.

* * *

>east
You can't go that way.

>dp
Bedroom
Your bedroom, the walls look kind of silly. Did the walls stucco always slide like that? Your bathroom is south of the Bedroom, the closet is to the east, the door to the outside to the northeast

You can see Bottle (in which is liquid) here.

>east
Closet
Kinda running low on clothes... man everything is so outdated, I never get new clothes, I NEVER get anything good for myself, I think I have some things I can wear though...

You gaze at the corner of the closet and stare at how dark it is. Your gaze wanders across the clothing rack, then slowly throughout the rest of it. The felt and fabrics begin to seem like a mirage, fake almost... you get a ping. You snap back to.

Your Berserk hoodie xdddddddddd

 Your head throbs, your vision gets blurry. You stare at nothing for a little. You come back to.

[Your score has just gone up by three points.]

>wear berserk hoodie
(first taking the Berserk Hoodie)
You put on the Berserk Hoodie.

>wear hoodie
You're already wearing that!

>x hoodie
You see nothing special about the Berserk Hoodie.